20
16
30
17
$........$.......#.$
.......##.#......#.#
..#....#.$......##..
.###.$.#...#.$.#.##.
..#...##....#.#..#..
..#..$.##$#..$...#.#
..#....#....#....#..
.###.$.#...#.$##.##.
..####.#..##.#.###.^
.......#.#.#.#...#..
$......#...#...#..$.
.......#...##....#..
...#.$.#...#.$##.##.
..####.#..#..#.###..
.........#...#...#..
$......#.......#..$.