21
11
30
8
..........$..........
.........#.#.........
...#......$......#...
....#.$.#...#.$.#....
.......#.....#.#.....
......$.......$......
.............#.......
....#.$.#...#.$.#....
...####.#..#....##..^
..........#..........
.....................